domnívat se=assume
mást,
znemožnit=baffle
zkreslený=biased
soustředit=concentrate
posoudit,
brát ohled=consider
zvažovat,
rozjímat=contemplate
cynický=cynical
odvodit,
dedukovat=deduce
důkladný,ozvážný=deliberate
dilema=dilemma
diskriminovat,
rozlišovat=discriminate
nejistý,
pochybný=dubious
odhad=estimate
víra=faith
shromáždit,
sebrat=gather
génius,
genialita=genius
úchop,
sevřít=grasp
hádání,
dohad=quesswork
předtucha,
tušení=hunch
ideologie=ideology
důmyslný=ingenious
inspirace=inspiration
intuice=intuition
ospravedlnit,
omlouvat=justify
naivní=naive
potucha,
ponětí=notion
optimistický=optimistic
